11111111111111111111
1P000000000000000001
10C00111100011110001
10000010000010000001
10C00010C00010C00001
10001110000011100001
10000000C00000000001
10001110000011100001
10C00010C00010C00001
100000000000000000E1
11111111111111111111
