11111111111111111111111111111111111111111111111111
1P0C00000000000000000000000000000000000C0000000001
10000000000000000000000000000000000000000000000001
1000010000000000000C00000C001100C000000C00000CC001
1000C1000C00000C000000C000000000000C00000C00000001
10000000000011100000000000000000000000000000000001
1C00000000C0000000000000000000000001111C0000000001
10000CC000C000000000000C000000000000CC000000010001
100CC0001C000000C0001000C00C0000000C00000000000001
10C0000000C00000000010CC0CC00C00000C0000000C000001
100000000000000000001000000000000000C0000000000001
100C000000000001000000000000000000000C000000000001
1000000C000C000000000010000000C0000000001110000001
100000C000000000000000000C000000000000C00000000001
100000C0001110000000000000000010000000000000CC00C1
100C0000000C00000000000001100000000000000000000001
10000000000000C00000000000000000000000000000000001
100000000C00000C0000000000000000000000000000000001
10000000000000000000000000000000000000000C00C0C0E1
11111111111111111111111111111111111111111111111111
