11111111111111111
1P0C0010000000101
10001000100110011
10000000000000001
10101010101010101
10000010000000101
10001000100110011
10100010001000101
10101010101010101
10000010000000101
11001100110111011
10000000000000001
10101010101010101
100000100000001E1
11001100110111011
10100010001000101
11111111111111111
